
123	123
a	a
abandon	abandon
abandoned	abandoned
ability	ability
able	able
about	about
above	above
abroad	abroad
absence	absence
absent	absent
absolute	absolute
absolutely	absolutely
absorb	absorb
abuse	abuse
academic	academic
accent	accent
accept	accept
acceptable	acceptable
access	access
accident	accident
accidental	accidental
accidentally	accidentally
accommodation	accommodation
accompany	accompany
according	according
account	account
accurate	accurate
accurately	accurately
accuse	accuse
achieve	achieve
achievement	achievement
acid	acid
acknowledge	acknowledge
acquire	acquire
across	across
act	act
action	action
active	active
actively	actively
activity	activity
actor	actor
actual	actual
actually	actually
adapt	adapt
add	add
addition	addition
addition	addition
additional	additional
address	address
adequate	adequate
adequately	adequately
adjust	adjust
admiration	admiration
admire	admire
admit	admit
adopt	adopt
adult	adult
advance	advance
advanced	advanced
advantage	advantage
adventure	adventure
advertise	advertise
advertisement	advertisement
advertisement	advertisement
advertising	advertising
advice	advice
advise	advise
affair	affair
affect	affect
affection	affection
afford	afford
afraid	afraid
after	after
afternoon	afternoon
afterwards	afterwards
again	again
against	against
age	age
aged	aged
agency	agency
agent	agent
aggressive	aggressive
ago	ago
agree	agree
agreement	agreement
ahead	ahead
aid	aid
aim	aim
air	air
aircraft	aircraft
airport	airport
alarm	alarm
alarmed	alarmed
alarming	alarming
alcohol	alcohol
alcoholic	alcoholic
alive	alive
all	all
all-right	all-right
allied	allied
allow	allow
ally	ally
almost	almost
alone	alone
along	along
alongside	alongside
aloud	aloud
alphabet	alphabet
alphabetical	alphabetical
alphabetically	alphabetically
already	already
also	also
alter	alter
alternative	alternative
alternatively	alternatively
although	although
altogether	altogether
always	always
amaze	amaze
amazed	amazed
amazing	amazing
ambition	ambition
ambulance	ambulance
among	among
amount	amount
amuse	amuse
amused	amused
amusing	amusing
analyse	analyse
analysis	analysis
ancient	ancient
and	and
anger	anger
angle	angle
angrily	angrily
angry	angry
animal	animal
ankle	ankle
anniversary	anniversary
announce	announce
annoy	annoy
annoyed	annoyed
annoying	annoying
annual	annual
annually	annually
another	another
answer	answer
anti-	anti-
anticipate	anticipate
anxiety	anxiety
anxious	anxious
anxiously	anxiously
any	any
anyone	anyone
anything	anything
anyway	anyway
anywhere	anywhere
apart	apart
apart	apart
apart	apart
apartment	apartment
apologize	apologize
apparent	apparent
apparently	apparently
appeal	appeal
appear	appear
appearance	appearance
apple	apple
application	application
apply	apply
appoint	appoint
appointment	appointment
appreciate	appreciate
approach	approach
appropriate	appropriate
approval	approval
approve	approve
approving	approving
approximate	approximate
approximately	approximately
april	april
area	area
argue	argue
argument	argument
arise	arise
arm	arm
armed	armed
arms	arms
army	army
around	around
arrange	arrange
arrangement	arrangement
arrest	arrest
arrival	arrival
arrive	arrive
arrow	arrow
art	art
article	article
artificial	artificial
artificially	artificially
artist	artist
artistic	artistic
as	as
as	as
as	as
ashamed	ashamed
aside	aside
aside	aside
ask	ask
asleep	asleep
aspect	aspect
assist	assist
assistance	assistance
assistant	assistant
associate	associate
associated	associated
association	association
assume	assume
assure	assure
at	at
at	at
atmosphere	atmosphere
atom	atom
attach	attach
attached	attached
attack	attack
attempt	attempt
attempted	attempted
attend	attend
attention	attention
attitude	attitude
attorney	attorney
attract	attract
attraction	attraction
attractive	attractive
audience	audience
august	august
aunt	aunt
author	author
authority	authority
automatic	automatic
automatically	automatically
autumn	autumn
available	available
average	average
avoid	avoid
awake	awake
award	award
aware	aware
away	away
awful	awful
awfully	awfully
awkward	awkward
awkwardly	awkwardly
back	back
background	background
backward	backward
backwards	backwards
bacteria	bacteria
bad	bad
bad-tempered	bad-tempered
badly	badly
bag	bag
baggage	baggage
bake	bake
balance	balance
ball	ball
ban	ban
band	band
bandage	bandage
bank	bank
bar	bar
bargain	bargain
barrier	barrier
base	base
based	based
basic	basic
basically	basically
basis	basis
bath	bath
bathroom	bathroom
battery	battery
battle	battle
bay	bay
be-called	be-called
be-going	be-going
be-sick	be-sick
beach	beach
beak	beak
bear	bear
beard	beard
beat	beat
beautiful	beautiful
beautifully	beautifully
beauty	beauty
because	because
because	because
become	become
bed	bed
bedroom	bedroom
beef	beef
beer	beer
before	before
begin	begin
beginning	beginning
behalf	behalf
behave	behave
behaviour	behaviour
behind	behind
belief	belief
believe	believe
bell	bell
belong	belong
below	below
belt	belt
bend	bend
beneath	beneath
benefit	benefit
bent	bent
beside	beside
bet	bet
better,	better,
betting	betting
between	between
beyond	beyond
bicycle	bicycle
bid	bid
big	big
bill	bill
bin	bin
biology	biology
bird	bird
birth	birth
birthday	birthday
biscuit	biscuit
bit	bit
bite	bite
bitter	bitter
bitterly	bitterly
black	black
blade	blade
blame	blame
blank	blank
blankly	blankly
blind	blind
block	block
blonde	blonde
blood	blood
blow	blow
blue	blue
board	board
boat	boat
body	body
boil	boil
bomb	bomb
bone	bone
book	book
boot	boot
border	border
bore	bore
bored	bored
boring	boring
born:	born:
borrow	borrow
boss	boss
both	both
bother	bother
bottle	bottle
bottom	bottom
bound	bound
bowl	bowl
box	box
boy	boy
boyfriend	boyfriend
brain	brain
branch	branch
brand	brand
brave	brave
bread	bread
break	break
breakfast	breakfast
breast	breast
breath	breath
breathe	breathe
breathing	breathing
breed	breed
brick	brick
bridge	bridge
brief	brief
briefly	briefly
bright	bright
brightly	brightly
brilliant	brilliant
bring	bring
broad	broad
broadcast	broadcast
broadly	broadly
broken	broken
brother	brother
brown	brown
brush	brush
bubble	bubble
budget	budget
build	build
building	building
bullet	bullet
bunch	bunch
burn	burn
burnt	burnt
burst	burst
bury	bury
bus	bus
bush	bush
business	business
businessman,	businessman,
busy	busy
but	but
butter	butter
button	button
buy	buy
buyer	buyer
by	by
by	by
bye	bye
cabinet	cabinet
cable	cable
cake	cake
calculate	calculate
calculation	calculation
call	call
calm	calm
calmly	calmly
camera	camera
camp	camp
campaign	campaign
camping	camping
can	can
cancel	cancel
cancer	cancer
candidate	candidate
candy	candy
cannot	cannot
cap	cap
capable	capable
capacity	capacity
capital	capital
captain	captain
capture	capture
car	car
card	card
cardboard	cardboard
care	care
care	care
career	career
careful	careful
carefully	carefully
careless	careless
carelessly	carelessly
carpet	carpet
carrot	carrot
carry	carry
case	case
cash	cash
cast	cast
castle	castle
cat	cat
catch	catch
category	category
cause	cause
cease	cease
ceiling	ceiling
celebrate	celebrate
celebration	celebration
cell	cell
cellphone	cellphone
cent	cent
cent	cent
centimetre	centimetre
centimetre	centimetre
central	central
centre	centre
century	century
ceremony	ceremony
certain	certain
certainly	certainly
certificate	certificate
chain	chain
chair	chair
chairman,	chairman,
challenge	challenge
chamber	chamber
chance	chance
change	change
channel	channel
chapter	chapter
character	character
characteristic	characteristic
charge	charge
charity	charity
chart	chart
chase	chase
chat	chat
cheap	cheap
cheaply	cheaply
cheat	cheat
check	check
cheek	cheek
cheerful	cheerful
cheerfully	cheerfully
cheese	cheese
chemical	chemical
chemist	chemist
chemistry	chemistry
chemist’s	chemist’s
cheque	cheque
chest	chest
chew	chew
chicken	chicken
chief	chief
child	child
chin	chin
chip	chip
chocolate	chocolate
choice	choice
choose	choose
chop	chop
church	church
cigarette	cigarette
cinema	cinema
circle	circle
circumstance	circumstance
citizen	citizen
city	city
civil	civil
claim	claim
clap	clap
class	class
classic	classic
classroom	classroom
clean	clean
clear	clear
clearly	clearly
clerk	clerk
clever	clever
click	click
client	client
climate	climate
climb	climb
climbing	climbing
clock	clock
close	close
close	close
closed	closed
closely	closely
closet	closet
cloth	cloth
clothes	clothes
clothing	clothing
cloud	cloud
club	club
coach	coach
coal	coal
coast	coast
coat	coat
code	code
coffee	coffee
coin	coin
cold	cold
coldly	coldly
collapse	collapse
colleague	colleague
collect	collect
collection	collection
college	college
colour	colour
coloured	coloured
column	column
combination	combination
combine	combine
come	come
comedy	comedy
comfort	comfort
comfortable	comfortable
comfortably	comfortably
command	command
comment	comment
commercial	commercial
commission	commission
commit	commit
commitment	commitment
committee	committee
common	common
commonly	commonly
communicate	communicate
communication	communication
community	community
company	company
compare	compare
comparison	comparison
compete	compete
competition	competition
competitive	competitive
complain	complain
complaint	complaint
complete	complete
completely	completely
complex	complex
complicate	complicate
complicated	complicated
computer	computer
concentrate	concentrate
concentration	concentration
concept	concept
concern	concern
concerned	concerned
concerning	concerning
concert	concert
conclude	conclude
conclusion	conclusion
concrete	concrete
condition	condition
conduct	conduct
conference	conference
confidence	confidence
confident	confident
confidently	confidently
confine	confine
confined	confined
confirm	confirm
conflict	conflict
confront	confront
confuse	confuse
confused	confused
confusing	confusing
confusion	confusion
congratulations	congratulations
congress	congress
connect	connect
connection	connection
conscious	conscious
consequence	consequence
conservative	conservative
consider	consider
considerable	considerable
considerably	considerably
consideration	consideration
consist	consist
constant	constant
constantly	constantly
construct	construct
construction	construction
consult	consult
consumer	consumer
contact	contact
contain	contain
container	container
contemporary	contemporary
content	content
contest	contest
context	context
continent	continent
continue	continue
continuous	continuous
continuously	continuously
contract	contract
contrast	contrast
contrasting	contrasting
contribute	contribute
contribution	contribution
control	control
controlled	controlled
convenient	convenient
convention	convention
conventional	conventional
conversation	conversation
convert	convert
convince	convince
cook	cook
cooker	cooker
cookie	cookie
cooking	cooking
cool	cool
cope	cope
copy	copy
core	core
corner	corner
correct	correct
correctly	correctly
cost	cost
cottage	cottage
cotton	cotton
cough	cough
coughing	coughing
could	could
could	could
council	council
count	count
counter	counter
country	country
countryside	countryside
county	county
couple	couple
courage	courage
course	course
court	court
cousin	cousin
cover	cover
covered	covered
covering	covering
cow	cow
crack	crack
cracked	cracked
craft	craft
crash	crash
crazy	crazy
cream	cream
create	create
creature	creature
credit	credit
credit	credit
crime	crime
criminal	criminal
crisis	crisis
crisp	crisp
criterion	criterion
critical	critical
criticism	criticism
criticize	criticize
crop	crop
cross	cross
crowd	crowd
crowded	crowded
crown	crown
crucial	crucial
cruel	cruel
crush	crush
cry	cry
cultural	cultural
culture	culture
cup	cup
cupboard	cupboard
curb	curb
cure	cure
curious	curious
curiously	curiously
curl	curl
curly	curly
current	current
currently	currently
curtain	curtain
curve	curve
curved	curved
custom	custom
customer	customer
customs	customs
cut	cut
cycle	cycle
cycling	cycling
dad	dad
daily	daily
damage	damage
damp	damp
dance	dance
dancer	dancer
dancing	dancing
danger	danger
dangerous	dangerous
dare	dare
dark	dark
data	data
date	date
daughter	daughter
day	day
dead	dead
deaf	deaf
deal	deal
deal	deal
dear	dear
death	death
debate	debate
debt	debt
decade	decade
decay	decay
december	december
decide	decide
decision	decision
declare	declare
decline	decline
decorate	decorate
decoration	decoration
decorative	decorative
decrease	decrease
deep	deep
deeply	deeply
defeat	defeat
defence	defence
defend	defend
define	define
definite	definite
definitely	definitely
definition	definition
degree	degree
delay	delay
deliberate	deliberate
deliberately	deliberately
delicate	delicate
delight	delight
delighted	delighted
deliver	deliver
delivery	delivery
demand	demand
demonstrate	demonstrate
dentist	dentist
deny	deny
department	department
departure	departure
depend	depend
deposit	deposit
depress	depress
depressed	depressed
depressing	depressing
depth	depth
derive	derive
describe	describe
description	description
desert	desert
deserted	deserted
deserve	deserve
design	design
desire	desire
desk	desk
desperate	desperate
desperately	desperately
despite	despite
destroy	destroy
destruction	destruction
detail	detail
detailed	detailed
determination	determination
determine	determine
determined	determined
develop	develop
development	development
device	device
devote	devote
devoted	devoted
diagram	diagram
diamond	diamond
diary	diary
dictionary	dictionary
die	die
diet	diet
difference	difference
different	different
differently	differently
difficult	difficult
difficulty	difficulty
dig	dig
dinner	dinner
direct	direct
direction	direction
directly	directly
director	director
dirt	dirt
dirty	dirty
disabled	disabled
disadvantage	disadvantage
disagree	disagree
disagreement	disagreement
disappear	disappear
disappoint	disappoint
disappointed	disappointed
disappointing	disappointing
disappointment	disappointment
disapproval	disapproval
disapprove	disapprove
disapproving	disapproving
disaster	disaster
disc	disc
discipline	discipline
discount	discount
discover	discover
discovery	discovery
discuss	discuss
discussion	discussion
disease	disease
disgust	disgust
disgusted	disgusted
disgusting	disgusting
dish	dish
dishonest	dishonest
dishonestly	dishonestly
disk	disk
dislike	dislike
dismiss	dismiss
display	display
dissolve	dissolve
distance	distance
distinguish	distinguish
distribute	distribute
distribution	distribution
district	district
disturb	disturb
disturbing	disturbing
divide	divide
division	division
divorce	divorce
divorced	divorced
do	do
doctor	doctor
document	document
dog	dog
dollar	dollar
domestic	domestic
dominate	dominate
door	door
dot	dot
double	double
doubt	doubt
down	down
downstairs	downstairs
downward	downward
downwards	downwards
dozen	dozen
draft	draft
drag	drag
drama	drama
dramatic	dramatic
dramatically	dramatically
draw	draw
drawer	drawer
drawing	drawing
dream	dream
dress	dress
dressed	dressed
drink	drink
drive	drive
driver	driver
driving	driving
drop	drop
drug	drug
drugstore	drugstore
drum	drum
drunk	drunk
dry	dry
due	due
due	due
dull	dull
dump	dump
during	during
dust	dust
duty	duty
dying	dying
e.g.	e.g.
each	each
each	each
each	each
ear	ear
early	early
earn	earn
earth	earth
ease	ease
easily	easily
east	east
eastern	eastern
easy	easy
eat	eat
economic	economic
economy	economy
edge	edge
edition	edition
editor	editor
educate	educate
educated	educated
education	education
effect	effect
effective	effective
effectively	effectively
efficient	efficient
efficiently	efficiently
effort	effort
egg	egg
either	either
elbow	elbow
elderly	elderly
elect	elect
election	election
electric	electric
electrical	electrical
electricity	electricity
electronic	electronic
elegant	elegant
element	element
elevator	elevator
else	else
elsewhere	elsewhere
email	email
embarrass	embarrass
embarrassed	embarrassed
embarrassing	embarrassing
embarrassment	embarrassment
emerge	emerge
emergency	emergency
emotion	emotion
emotional	emotional
emotionally	emotionally
emphasis	emphasis
emphasize	emphasize
empire	empire
employ	employ
employee	employee
employer	employer
employment	employment
empty	empty
enable	enable
encounter	encounter
encourage	encourage
encouragement	encouragement
end	end
ending	ending
enemy	enemy
energy	energy
engage	engage
engaged	engaged
engine	engine
engineer	engineer
engineering	engineering
enjoy	enjoy
enjoyable	enjoyable
enjoyment	enjoyment
enormous	enormous
enough	enough
enquiry	enquiry
ensure	ensure
enter	enter
entertain	entertain
entertainer	entertainer
entertaining	entertaining
entertainment	entertainment
enthusiasm	enthusiasm
enthusiastic	enthusiastic
entire	entire
entirely	entirely
entitle	entitle
entrance	entrance
entry	entry
envelope	envelope
environment	environment
environmental	environmental
equal	equal
equally	equally
equipment	equipment
equivalent	equivalent
error	error
escape	escape
especially	especially
essay	essay
essential	essential
essentially	essentially
establish	establish
estate	estate
estimate	estimate
etc.	etc.
euro	euro
even	even
evening	evening
event	event
eventually	eventually
ever	ever
every	every
everyone	everyone
everything	everything
everywhere	everywhere
evidence	evidence
evil	evil
ex-	ex-
exact	exact
exactly	exactly
exaggerate	exaggerate
exaggerated	exaggerated
exam	exam
examination	examination
examine	examine
example	example
excellent	excellent
except	except
exception	exception
exchange	exchange
excite	excite
excited	excited
excitement	excitement
exciting	exciting
exclude	exclude
excluding	excluding
excuse	excuse
executive	executive
exercise	exercise
exhibit	exhibit
exhibition	exhibition
exist	exist
existence	existence
exit	exit
expand	expand
expect	expect
expectation	expectation
expected	expected
expense	expense
expensive	expensive
experience	experience
experienced	experienced
experiment	experiment
expert	expert
explain	explain
explanation	explanation
explode	explode
explore	explore
explosion	explosion
export	export
expose	expose
express	express
expression	expression
extend	extend
extension	extension
extensive	extensive
extent	extent
extra	extra
extraordinary	extraordinary
extreme	extreme
extremely	extremely
eye	eye
face	face
facility	facility
fact	fact
factor	factor
factory	factory
fail	fail
failure	failure
faint	faint
faintly	faintly
fair	fair
fairly	fairly
faith	faith
faithful	faithful
faithfully	faithfully
fall	fall
fall	fall
fall	fall
false	false
fame	fame
familiar	familiar
family	family
famous	famous
fan	fan
fancy	fancy
far	far
farm	farm
farmer	farmer
farming	farming
fashion	fashion
fashionable	fashionable
fast	fast
fasten	fasten
fat	fat
father	father
faucet	faucet
fault	fault
favour	favour
favourite	favourite
fear	fear
feather	feather
feature	feature
february	february
federal	federal
fee	fee
feed	feed
feel	feel
feel	feel
feeling	feeling
fellow	fellow
female	female
fence	fence
festival	festival
fetch	fetch
fever	fever
few	few
field	field
fight	fight
fighting	fighting
figure	figure
file	file
fill	fill
film	film
final	final
finally	finally
finance	finance
financial	financial
find	find
find	find
fine	fine
finely	finely
finger	finger
finish	finish
finished	finished
fire	fire
firm	firm
firmly	firmly
first	first
fish	fish
fishing	fishing
fit	fit
fix	fix
fixed	fixed
flag	flag
flame	flame
flash	flash
flat	flat
flavour	flavour
flesh	flesh
flight	flight
float	float
flood	flood
floor	floor
flour	flour
flow	flow
flower	flower
flu	flu
fly	fly
flying	flying
focus	focus
fold	fold
folding	folding
follow	follow
following	following
food	food
foot	foot
football	football
for	for
for	for
force	force
forecast	forecast
foreign	foreign
forest	forest
forever	forever
forget	forget
forgive	forgive
fork	fork
form	form
formal	formal
formally	formally
former	former
formerly	formerly
formula	formula
fortune	fortune
forward	forward
forward	forward
found	found
foundation	foundation
frame	frame
free	free
freedom	freedom
freely	freely
freeze	freeze
freeze	freeze
frequent	frequent
frequently	frequently
fresh	fresh
freshly	freshly
friday	friday
fridge	fridge
friend	friend
friendly	friendly
friendship	friendship
frighten	frighten
frightened	frightened
frightening	frightening
from	from
front	front
frozen	frozen
fruit	fruit
fry	fry
fuel	fuel
full	full
fully	fully
fun	fun
function	function
fund	fund
fundamental	fundamental
funeral	funeral
funny	funny
fur	fur
furniture	furniture
further	further
further,	further,
future	future
gain	gain
gallon	gallon
gamble	gamble
gambling	gambling
game	game
gap	gap
garage	garage
garbage	garbage
garden	garden
gas	gas
gasoline	gasoline
gate	gate
gather	gather
gear	gear
general	general
generally	generally
generate	generate
generation	generation
generous	generous
generously	generously
gentle	gentle
gentleman	gentleman
gently	gently
genuine	genuine
genuinely	genuinely
geography	geography
get	get
get	get
get	get
giant	giant
gift	gift
girl	girl
girlfriend	girlfriend
give	give
give	give
give	give
give	give
give	give
glad	glad
glass	glass
glasses	glasses
global	global
glove	glove
glue	glue
go	go
go	go
go	go
go	go
go	go
goal	goal
god	god
gold	gold
good	good
good	good
good	good
good,	good,
goodbye	goodbye
goods	goods
govern	govern
government	government
governor	governor
grab	grab
grade	grade
gradual	gradual
gradually	gradually
grain	grain
gram	gram
gram	gram
grammar	grammar
grand	grand
grandchild	grandchild
granddaughter	granddaughter
grandfather	grandfather
grandmother	grandmother
grandparent	grandparent
grandson	grandson
grant	grant
grass	grass
grateful	grateful
grave	grave
gray(NAmE)	gray(NAmE)
great	great
greatly	greatly
green	green
grey	grey
grey	grey
groceries	groceries
grocery	grocery
ground	ground
group	group
grow	grow
grow	grow
growth	growth
guarantee	guarantee
guard	guard
guess	guess
guest	guest
guide	guide
guilty	guilty
gun	gun
guy	guy
habit	habit
hair	hair
hairdresser	hairdresser
half	half
hall	hall
hammer	hammer
hand	hand
handle	handle
hang	hang
happen	happen
happily	happily
happiness	happiness
happy	happy
hard	hard
hardly	hardly
harm	harm
harmful	harmful
harmless	harmless
hat	hat
hate	hate
hatred	hatred
have	have
have	have
he	he
head	head
headache	headache
heal	heal
health	health
healthy	healthy
hear	hear
hearing	hearing
heart	heart
heat	heat
heating	heating
heaven	heaven
heavily	heavily
heavy	heavy
heel	heel
height	height
hell	hell
hello	hello
help	help
helpful	helpful
hence	hence
her	her
here	here
hero	hero
hers	hers
herself	herself
hesitate	hesitate
hide	hide
high	high
highlight	highlight
highly	highly
highway	highway
hill	hill
him	him
himself	himself
hip	hip
hire	hire
his	his
historical	historical
history	history
hit	hit
hobby	hobby
hold	hold
hole	hole
holiday	holiday
hollow	hollow
holy	holy
home	home
homework	homework
honest	honest
honestly	honestly
honour	honour
hook	hook
hope	hope
horizontal	horizontal
horn	horn
horror	horror
horse	horse
hospital	hospital
host	host
hot	hot
hotel	hotel
hour	hour
house	house
household	household
housing	housing
how	how
however	however
huge	huge
human	human
humorous	humorous
humour	humour
hungry	hungry
hunt	hunt
hunting	hunting
hurry	hurry
hurt	hurt
husband	husband
i.e.	i.e.
ice	ice
ice	ice
idea	idea
ideal	ideal
ideally	ideally
identify	identify
identity	identity
if	if
ignore	ignore
ill	ill
illegal	illegal
illegally	illegally
illness	illness
illustrate	illustrate
image	image
imaginary	imaginary
imagination	imagination
imagine	imagine
immediate	immediate
immediately	immediately
immoral	immoral
impact	impact
impatient	impatient
impatiently	impatiently
implication	implication
imply	imply
import	import
importance	importance
important	important
importantly	importantly
impose	impose
impossible	impossible
impress	impress
impressed	impressed
impression	impression
impressive	impressive
improve	improve
improvement	improvement
in-a-hurry	in-a-hurry
in-advance	in-advance
in-case-(of)	in-case-(of)
in-charge-of	in-charge-of
in-common	in-common
in-control-(of)	in-control-(of)
in-detail	in-detail
in-exchange-(for)	in-exchange-(for)
in-favour/favor-(of)	in-favour/favor-(of)
in-front-(of)	in-front-(of)
in-general	in-general
in-honour/honor-of	in-honour/honor-of
in-memory-of	in-memory-of
in-order-to	in-order-to
in-prep.,	in-prep.,
in-public	in-public
in-the-end	in-the-end
inability	inability
inch	inch
incident	incident
include	include
including	including
income	income
increase	increase
increasingly	increasingly
indeed	indeed
independence	independence
independent	independent
independently	independently
index	index
indicate	indicate
indication	indication
indirect	indirect
indirectly	indirectly
individual	individual
indoor	indoor
indoors	indoors
industrial	industrial
industry	industry
inevitable	inevitable
inevitably	inevitably
infect	infect
infected	infected
infection	infection
infectious	infectious
influence	influence
inform	inform
informal	informal
information	information
ingredient	ingredient
initial	initial
initially	initially
initiative	initiative
injure	injure
injured	injured
injury	injury
ink	ink
inner	inner
innocent	innocent
insect	insect
insert	insert
inside	inside
insist	insist
install	install
instance	instance
instead	instead
instead-of	instead-of
institute	institute
institution	institution
instruction	instruction
instrument	instrument
insult	insult
insulting	insulting
insurance	insurance
intelligence	intelligence
intelligent	intelligent
intend	intend
intended	intended
intention	intention
interest	interest
interested	interested
interesting	interesting
interior	interior
internal	internal
international	international
internet	internet
interpret	interpret
interpretation	interpretation
interrupt	interrupt
interruption	interruption
interval	interval
interview	interview
into	into
introduce	introduce
introduction	introduction
invent	invent
invention	invention
invest	invest
investigate	investigate
investigation	investigation
investment	investment
invitation	invitation
invite	invite
involve	involve
involved	involved
involvement	involvement
iron	iron
irritate	irritate
irritated	irritated
irritating	irritating
island	island
issue	issue
it	it
item	item
its	its
itself	itself
jacket	jacket
jam	jam
january	january
jealous	jealous
jeans	jeans
jelly	jelly
jewellery	jewellery
job	job
join	join
joint	joint
jointly	jointly
joke	joke
journalist	journalist
journey	journey
joy	joy
judge	judge
judgement	judgement
juice	juice
july	july
jump	jump
june	june
junior	junior
just	just
justice	justice
justified	justified
justify	justify
keen	keen
keen	keen
keep	keep
key	key
keyboard	keyboard
kick	kick
kid	kid
kill	kill
killing	killing
kilogram	kilogram
kilometre	kilometre
kilometre	kilometre
kind	kind
kindly	kindly
kindness	kindness
king	king
kiss	kiss
kitchen	kitchen
knee	knee
knife	knife
knit	knit
knitted	knitted
knitting	knitting
knock	knock
knot	knot
know	know
knowledge	knowledge
label	label
laboratory,	laboratory,
labour	labour
lack	lack
lacking	lacking
lady	lady
lake	lake
lamp	lamp
land	land
landscape	landscape
lane	lane
language	language
large	large
largely	largely
last	last
late	late
later	later
latest	latest
latter	latter
laugh	laugh
launch	launch
law	law
lawyer	lawyer
lay	lay
layer	layer
lazy	lazy
lead	lead
leader	leader
leading	leading
leaf	leaf
league	league
lean	lean
learn	learn
least	least
leather	leather
leave	leave
leave	leave
lecture	lecture
left	left
leg	leg
legal	legal
legally	legally
lemon	lemon
lend	lend
length	length
less	less
lesson	lesson
let	let
letter	letter
level	level
library	library
licence	licence
license	license
lid	lid
lie	lie
life	life
lift	lift
light	light
lightly	lightly
like	like
likely	likely
limit	limit
limited	limited
line	line
link	link
lip	lip
liquid	liquid
list	list
listen	listen
literature	literature
litre	litre
litre	litre
little	little
live	live
live	live
lively	lively
living	living
load	load
loan	loan
local	local
locally	locally
locate	locate
located	located
location	location
lock	lock
logic	logic
logical	logical
lonely	lonely
long	long
look	look
look-after	look-after
look-at	look-at
look-for	look-for
look-forward-to	look-forward-to
loose	loose
loosely	loosely
lord	lord
lorry	lorry
lose	lose
loss	loss
lost	lost
lot:	lot:
loud	loud
loudly	loudly
love	love
lovely	lovely
lover	lover
low	low
loyal	loyal
luck	luck
lucky	lucky
luggage	luggage
lump	lump
lunch	lunch
lung	lung
machine	machine
machinery	machinery
mad	mad
magazine	magazine
magic	magic
mail	mail
main	main
mainly	mainly
maintain	maintain
major	major
majority	majority
make	make
make-friends-(with)	make-friends-(with)
make-fun-of	make-fun-of
make-sth-up	make-sth-up
make-sure	make-sure
make-up	make-up
male	male
mall	mall
man	man
manage	manage
management	management
manager	manager
manner	manner
manufacture	manufacture
manufacturer	manufacturer
manufacturing	manufacturing
many	many
map	map
march	march
march	march
mark	mark
market	market
marketing	marketing
marriage	marriage
married	married
marry	marry
mass	mass
massive	massive
master	master
match	match
matching	matching
mate	mate
material	material
mathematics	mathematics
matter	matter
maximum	maximum
may	may
may	may
maybe	maybe
mayor	mayor
me	me
meal	meal
mean	mean
meaning	meaning
means	means
meanwhile	meanwhile
measure	measure
measurement	measurement
meat	meat
media	media
medical	medical
medicine	medicine
medium	medium
meet	meet
meeting	meeting
melt	melt
member	member
membership	membership
memory	memory
mental	mental
mentally	mentally
mention	mention
menu	menu
mere	mere
merely	merely
mess	mess
message	message
metal	metal
method	method
metre	metre
mid-	mid-
midday	midday
middle	middle
midnight	midnight
might	might
mild	mild
mile	mile
military	military
milk	milk
milligram	milligram
millimetre	millimetre
mind	mind
mine	mine
mineral	mineral
minimum	minimum
minister	minister
ministry	ministry
minor	minor
minority	minority
minute	minute
mirror	mirror
miss	miss
miss	miss
missing	missing
mistake	mistake
mistaken	mistaken
mix	mix
mixed	mixed
mixture	mixture
mobile	mobile
mobile	mobile
model	model
modern	modern
moment	moment
monday	monday
money	money
monitor	monitor
month	month
mood	mood
moon	moon
moral	moral
morally	morally
more	more
moreover	moreover
morning	morning
most	most
mostly	mostly
mother	mother
motion	motion
motor	motor
motorcycle	motorcycle
mount	mount
mountain	mountain
mouse	mouse
mouth	mouth
move	move
movement	movement
movie	movie
movie	movie
moving	moving
mr	mr
mrs	mrs
ms	ms
much	much
mud	mud
multiply	multiply
mum	mum
mum	mum
murder	murder
muscle	muscle
museum	museum
music	music
musical	musical
musician	musician
must	must
my	my
myself	myself
mysterious	mysterious
mystery	mystery
nail	nail
naked	naked
name	name
narrow	narrow
nation	nation
national	national
natural	natural
naturally	naturally
nature	nature
navy	navy
near	near
nearby	nearby
nearly	nearly
neat	neat
neatly	neatly
necessarily	necessarily
necessary	necessary
neck	neck
need	need
needle	needle
negative	negative
neighbour	neighbour
neighbourhood	neighbourhood
neither	neither
nephew	nephew
nerve	nerve
nervous	nervous
nervously	nervously
nest	nest
net	net
network	network
never	never
nevertheless	nevertheless
new	new
newly	newly
news	news
newspaper	newspaper
next	next
next	next
nice	nice
nicely	nicely
niece	niece
night	night
no	no
nobody	nobody
noise	noise
noisily	noisily
noisy	noisy
non-	non-
none	none
nonsense	nonsense
nor	nor
normal	normal
normally	normally
north	north
northern	northern
nose	nose
not	not
note	note
nothing	nothing
notice	notice
noticeable	noticeable
novel	novel
november	november
now	now
nowhere	nowhere
nuclear	nuclear
number	number
nurse	nurse
nut	nut
obey	obey
object	object
objective	objective
observation	observation
observe	observe
obtain	obtain
obvious	obvious
obviously	obviously
occasion	occasion
occasionally	occasionally
occupied	occupied
occupy	occupy
occur	occur
ocean	ocean
october	october
odd	odd
oddly	oddly
of-course	of-course
of-prep.	of-prep.
off	off
offence	offence
offend	offend
offensive	offensive
offer	offer
office	office
officer	officer
official	official
officially	officially
often	often
oh	oh
oil	oil
ok	ok
old	old
old-fashioned	old-fashioned
on-behalf-of-sb	on-behalf-of-sb
on-board	on-board
on-prep.,	on-prep.,
on-purpose	on-purpose
on-sb’s-behalf	on-sb’s-behalf
once	once
one	one
onion	onion
only	only
onto	onto
open	open
opening	opening
openly	openly
operate	operate
operation	operation
opinion	opinion
opponent	opponent
opportunity	opportunity
oppose	oppose
opposed-to	opposed-to
opposing	opposing
opposite	opposite
opposition	opposition
option	option
orange	orange
order	order
ordinary	ordinary
organ	organ
organization	organization
organize	organize
organized	organized
origin	origin
original	original
originally	originally
other	other
otherwise	otherwise
ought	ought
our	our
ours	ours
ourselves	ourselves
out-(of)	out-(of)
outdoor	outdoor
outdoors	outdoors
outer	outer
outline	outline
output	output
outside	outside
outstanding	outstanding
oven	oven
over	over
overall	overall
overcome	overcome
owe	owe
own	own
owner	owner
o’clock	o’clock
p.m.	p.m.
pace	pace
pack	pack
package	package
packaging	packaging
packet	packet
page	page
pain	pain
painful	painful
paint	paint
painter	painter
painting	painting
pair	pair
palace	palace
pale	pale
pan	pan
panel	panel
pants	pants
paper	paper
parallel	parallel
parent	parent
park	park
parliament	parliament
part	part
particular	particular
particularly	particularly
partly	partly
partner	partner
partnership	partnership
party	party
pass	pass
passage	passage
passenger	passenger
passing	passing
passport	passport
past	past
path	path
patience	patience
patient	patient
pattern	pattern
pause	pause
pay	pay
pay	pay
payment	payment
peace	peace
peaceful	peaceful
peak	peak
pen	pen
pence	pence
pencil	pencil
penny	penny
penny	penny
pension	pension
people	people
pepper	pepper
per	per
per	per
perfect	perfect
perfectly	perfectly
perform	perform
performance	performance
performer	performer
perhaps	perhaps
period	period
permanent	permanent
permanently	permanently
permission	permission
permit	permit
person	person
personal	personal
personality	personality
personally	personally
persuade	persuade
pet	pet
petrol	petrol
phase	phase
philosophy	philosophy
photocopy	photocopy
photograph	photograph
photographer	photographer
photography	photography
phrase	phrase
physical	physical
physically	physically
physics	physics
piano	piano
pick	pick
pick	pick
picture	picture
piece	piece
pig	pig
pile	pile
pill	pill
pilot	pilot
pin	pin
pink	pink
pint	pint
pint	pint
pipe	pipe
pitch	pitch
pity	pity
place	place
plain	plain
plan	plan
plane	plane
planet	planet
planning	planning
plant	plant
plastic	plastic
plate	plate
platform	platform
play	play
player	player
pleasant	pleasant
pleasantly	pleasantly
please	please
pleased	pleased
pleasing	pleasing
pleasure	pleasure
plenty	plenty
plot	plot
plug	plug
plus	plus
pocket	pocket
poem	poem
poetry	poetry
point	point
pointed	pointed
poison	poison
poisonous	poisonous
pole	pole
police	police
policy	policy
polish	polish
polite	polite
politely	politely
political	political
politically	politically
politician	politician
politics	politics
pollution	pollution
pool	pool
poor	poor
pop	pop
popular	popular
population	population
port	port
pose	pose
position	position
positive	positive
possess	possess
possession	possession
possibility	possibility
possible	possible
possibly	possibly
post	post
post-office	post-office
pot	pot
potato	potato
potential	potential
potentially	potentially
pound	pound
pour	pour
powder	powder
power	power
powerful	powerful
practical	practical
practically	practically
practice	practice
practise	practise
praise	praise
prayer	prayer
precise	precise
precisely	precisely
predict	predict
prefer	prefer
preference	preference
pregnant	pregnant
premises	premises
preparation	preparation
prepare	prepare
prepared	prepared
presence	presence
present	present
presentation	presentation
preserve	preserve
president	president
press	press
pressure	pressure
presumably	presumably
pretend	pretend
pretty	pretty
prevent	prevent
previous	previous
previously	previously
price	price
pride	pride
priest	priest
primarily	primarily
primary	primary
prime-minister	prime-minister
prince	prince
princess	princess
principle	principle
print	print
printer	printer
printing	printing
prior	prior
priority	priority
prison	prison
prisoner	prisoner
private	private
privately	privately
prize	prize
probable	probable
probably	probably
problem	problem
procedure	procedure
proceed	proceed
process	process
produce	produce
producer	producer
product	product
production	production
profession	profession
professional	professional
professor	professor
profit	profit
program	program
programme	programme
progress	progress
project	project
promise	promise
promote	promote
promotion	promotion
prompt	prompt
promptly	promptly
pronounce	pronounce
pronunciation	pronunciation
proof	proof
proper	proper
properly	properly
property	property
proportion	proportion
proposal	proposal
propose	propose
prospect	prospect
protect	protect
protection	protection
protest	protest
proud	proud
proudly	proudly
prove	prove
provide	provide
provided-(also	provided-(also
pub	pub
public	public
publication	publication
publicity	publicity
publicly	publicly
publish	publish
publishing	publishing
pull	pull
punch	punch
punish	punish
punishment	punishment
pupil	pupil
purchase	purchase
pure	pure
purely	purely
purple	purple
purpose	purpose
pursue	pursue
push	push
put	put
put	put
put	put
qualification	qualification
qualified	qualified
qualify	qualify
quality	quality
quantity	quantity
quarter	quarter
queen	queen
question	question
quick	quick
quickly	quickly
quiet	quiet
quietly	quietly
quit	quit
quite	quite
quote	quote
race	race
racing	racing
radio	radio
rail	rail
railway	railway
rain	rain
raise	raise
range	range
rank	rank
rapid	rapid
rapidly	rapidly
rare	rare
rarely	rarely
rate	rate
rather	rather
rather	rather
raw	raw
reach	reach
react	react
reaction	reaction
read	read
reader	reader
reading	reading
ready	ready
real	real
realistic	realistic
reality	reality
realize	realize
really	really
rear	rear
reason	reason
reasonable	reasonable
reasonably	reasonably
recall	recall
receipt	receipt
receive	receive
recent	recent
recently	recently
reception	reception
reckon	reckon
recognition	recognition
recognize	recognize
recommend	recommend
record	record
recording	recording
recover	recover
red	red
reduce	reduce
reduction	reduction
refer	refer
reference	reference
reflect	reflect
reform	reform
refrigerator	refrigerator
refusal	refusal
refuse	refuse
regard	regard
regarding	regarding
region	region
regional	regional
register	register
regret	regret
regular	regular
regularly	regularly
regulation	regulation
reject	reject
relate	relate
related	related
relation	relation
relationship	relationship
relative	relative
relatively	relatively
relax	relax
relaxed	relaxed
relaxing	relaxing
release	release
relevant	relevant
relief	relief
religion	religion
religious	religious
rely	rely
remain	remain
remaining	remaining
remains	remains
remark	remark
remarkable	remarkable
remarkably	remarkably
remember	remember
remind	remind
remote	remote
removal	removal
remove	remove
rent	rent
rented	rented
repair	repair
repeat	repeat
repeated	repeated
repeatedly	repeatedly
replace	replace
reply	reply
report	report
represent	represent
representative	representative
reproduce	reproduce
reputation	reputation
request	request
require	require
requirement	requirement
rescue	rescue
research	research
reservation	reservation
reserve	reserve
resident	resident
resist	resist
resistance	resistance
resolve	resolve
resort	resort
resource	resource
respect	respect
respond	respond
response	response
responsibility	responsibility
responsible	responsible
rest	rest
restaurant	restaurant
restore	restore
restrict	restrict
restricted	restricted
restriction	restriction
result	result
retain	retain
retire	retire
retired	retired
retirement	retirement
return	return
reveal	reveal
reverse	reverse
review	review
revise	revise
revision	revision
revolution	revolution
reward	reward
rhythm	rhythm
rice	rice
rich	rich
rid	rid
ride	ride
rider	rider
ridiculous	ridiculous
riding	riding
right	right
rightly	rightly
ring	ring
rise	rise
risk	risk
rival	rival
river	river
road	road
rob	rob
rock	rock
role	role
roll	roll
romantic	romantic
roof	roof
room	room
root	root
rope	rope
rough	rough
roughly	roughly
round	round
rounded	rounded
route	route
routine	routine
row	row
royal	royal
rub	rub
rubber	rubber
rubbish	rubbish
rude	rude
rudely	rudely
ruin	ruin
ruined	ruined
rule	rule
ruler	ruler
rumour	rumour
run	run
runner	runner
running	running
rural	rural
rush	rush
sack	sack
sad	sad
sadly	sadly
sadness	sadness
safe	safe
safely	safely
safety	safety
sail	sail
sailing	sailing
sailor	sailor
salad	salad
salary	salary
sale	sale
salt	salt
salty	salty
same	same
sample	sample
sand	sand
satisfaction	satisfaction
satisfied	satisfied
satisfy	satisfy
satisfying	satisfying
saturday	saturday
sauce	sauce
save	save
saving	saving
say	say
scale	scale
scare	scare
scared	scared
scene	scene
schedule	schedule
scheme	scheme
school	school
science	science
scientific	scientific
scientist	scientist
scissors	scissors
score	score
scratch	scratch
scream	scream
screen	screen
screw	screw
sea	sea
seal	seal
search	search
season	season
seat	seat
second	second
secondary	secondary
secret	secret
secretary	secretary
secretly	secretly
section	section
sector	sector
secure	secure
security	security
see	see
seed	seed
seek	seek
seem	seem
select	select
selection	selection
self	self
self-	self-
sell	sell
senate	senate
senator	senator
send	send
senior	senior
sense	sense
sensible	sensible
sensitive	sensitive
sentence	sentence
separate	separate
separated	separated
separately	separately
separation	separation
september	september
series	series
serious	serious
seriously	seriously
servant	servant
serve	serve
service	service
session	session
set	set
set	set
settle	settle
several	several
severe	severe
severely	severely
sew	sew
sewing	sewing
sex	sex
sexual	sexual
sexually	sexually
shade	shade
shadow	shadow
shake	shake
shall	shall
shallow	shallow
shame	shame
shape	shape
shaped	shaped
share	share
sharp	sharp
sharply	sharply
shave	shave
she	she
sheep	sheep
sheet	sheet
shelf	shelf
shell	shell
shelter	shelter
shift	shift
shine	shine
shiny	shiny
ship	ship
shirt	shirt
shock	shock
shocked	shocked
shocking	shocking
shoe	shoe
shoot	shoot
shooting	shooting
shop	shop
shopping	shopping
short	short
shortly	shortly
shot	shot
should	should
shoulder	shoulder
shout	shout
show	show
shower	shower
shursday	shursday
shut	shut
shy	shy
sick	sick
side	side
sideways	sideways
sight	sight
sign	sign
signal	signal
signature	signature
significant	significant
significantly	significantly
silence	silence
silent	silent
silk	silk
silly	silly
silver	silver
similar	similar
similarly	similarly
simple	simple
simply	simply
since	since
sincere	sincere
sincerely	sincerely
sing	sing
singer	singer
singing	singing
single	single
sink	sink
sir	sir
sister	sister
sit	sit
sit	sit
site	site
situation	situation
size	size
sized	sized
skilful	skilful
skilfully	skilfully
skill	skill
skilled	skilled
skin	skin
skirt	skirt
sky	sky
sleep	sleep
sleeve	sleeve
slice	slice
slide	slide
slight	slight
slightly	slightly
slip	slip
slope	slope
slow	slow
slowly	slowly
small	small
smart	smart
smash	smash
smell	smell
smile	smile
smoke	smoke
smoking	smoking
smooth	smooth
smoothly	smoothly
snake	snake
snow	snow
so	so
so	so
soap	soap
social	social
socially	socially
society	society
sock	sock
soft	soft
softly	softly
software	software
soil	soil
soldier	soldier
solid	solid
solution	solution
solve	solve
some	some
somebody	somebody
somehow	somehow
something	something
sometimes	sometimes
somewhat	somewhat
somewhere	somewhere
son	son
song	song
soon	soon
sore	sore
sorry	sorry
sort	sort
soul	soul
sound	sound
soup	soup
sour	sour
source	source
south	south
southern	southern
space	space
spare	spare
speak	speak
speaker	speaker
special	special
specialist	specialist
specially	specially
specific	specific
specifically	specifically
speech	speech
speed	speed
spell	spell
spelling	spelling
spend	spend
spice	spice
spicy	spicy
spider	spider
spin	spin
spirit	spirit
spiritual	spiritual
spite	spite
split	split
spoil	spoil
spoken	spoken
spoon	spoon
sport	sport
spot	spot
spray	spray
spread	spread
spring	spring
square	square
squeeze	squeeze
stable	stable
staff	staff
stage	stage
stair	stair
stamp	stamp
stand	stand
stand	stand
standard	standard
star	star
stare	stare
start	start
state	state
statement	statement
station	station
statue	statue
status	status
stay	stay
steadily	steadily
steady	steady
steal	steal
steam	steam
steel	steel
steep	steep
steeply	steeply
steer	steer
step	step
stick	stick
stick	stick
sticky	sticky
stiff	stiff
stiffly	stiffly
still	still
sting	sting
stir	stir
stock	stock
stomach	stomach
stone	stone
stop	stop
store	store
storm	storm
story	story
stove	stove
straight	straight
strain	strain
strange	strange
strangely	strangely
stranger	stranger
strategy	strategy
stream	stream
street	street
strength	strength
stress	stress
stressed	stressed
stretch	stretch
strict	strict
strictly	strictly
strike	strike
striking	striking
string	string
strip	strip
stripe	stripe
striped	striped
stroke	stroke
strong	strong
strongly	strongly
structure	structure
struggle	struggle
student	student
studio	studio
study	study
stuff	stuff
stupid	stupid
style	style
subject	subject
substance	substance
substantial	substantial
substantially	substantially
substitute	substitute
succeed	succeed
success	success
successful	successful
successfully	successfully
such	such
such	such
suck	suck
sudden	sudden
suddenly	suddenly
suffer	suffer
suffering	suffering
sufficient	sufficient
sufficiently	sufficiently
sugar	sugar
suggest	suggest
suggestion	suggestion
suit	suit
suitable	suitable
suitcase	suitcase
suited	suited
sum	sum
summary	summary
summer	summer
sun	sun
sunday	sunday
superior	superior
supermarket	supermarket
supply	supply
support	support
supporter	supporter
suppose	suppose
sure	sure
surely	surely
surface	surface
surname	surname
surprise	surprise
surprised	surprised
surprising	surprising
surprisingly	surprisingly
surround	surround
surrounding	surrounding
surroundings	surroundings
survey	survey
survive	survive
suspect	suspect
suspicion	suspicion
suspicious	suspicious
swallow	swallow
swear	swear
swearing	swearing
sweat	sweat
sweater	sweater
sweep	sweep
sweet	sweet
swell	swell
swelling	swelling
swim	swim
swimming	swimming
swimming	swimming
swing	swing
switch	switch
switch	switch
switch	switch
swollen	swollen
swollen	swollen
symbol	symbol
sympathetic	sympathetic
sympathy	sympathy
system	system
table	table
tablet	tablet
tackle	tackle
tail	tail
take	take
take	take
take	take
take	take
take	take
take	take
take	take
take	take
take	take
talk	talk
tall	tall
tank	tank
tap	tap
tape	tape
target	target
task	task
taste	taste
tax	tax
taxi	taxi
tea	tea
teach	teach
teacher	teacher
teaching	teaching
team	team
tear	tear
technical	technical
technique	technique
technology	technology
telephone	telephone
television	television
tell	tell
temperature	temperature
temporarily	temporarily
temporary	temporary
tend	tend
tendency	tendency
tension	tension
tent	tent
term	term
terrible	terrible
terribly	terribly
test	test
text	text
than	than
thank	thank
thank	thank
thanks	thanks
that	that
the	the
the	the
the	the
theatre	theatre
their	their
theirs	theirs
them	them
theme	theme
themselves	themselves
then	then
theory	theory
there	there
therefore	therefore
they	they
thick	thick
thickly	thickly
thickness	thickness
thief	thief
thin	thin
thing	thing
think	think
thinking	thinking
thirsty	thirsty
this	this
thorough	thorough
thoroughly	thoroughly
though	though
thought	thought
thread	thread
threat	threat
threaten	threaten
threatening	threatening
throat	throat
through	through
throughout	throughout
throw	throw
throw	throw
thumb	thumb
thus	thus
ticket	ticket
tidy	tidy
tie	tie
tie	tie
tight	tight
tightly	tightly
till	till
time	time
timetable	timetable
tin	tin
tiny	tiny
tip	tip
tire	tire
tired	tired
tiring	tiring
title	title
to	to
today	today
toe	toe
together	together
toilet	toilet
tomato	tomato
tomorrow	tomorrow
ton	ton
tone	tone
tongue	tongue
tonight	tonight
tonne	tonne
too	too
tool	tool
tooth	tooth
top	top
topic	topic
total	total
totally	totally
touch	touch
tough	tough
tour	tour
tourist	tourist
towards	towards
towel	towel
tower	tower
town	town
toy	toy
trace	trace
track	track
trade	trade
trading	trading
tradition	tradition
traditional	traditional
traditionally	traditionally
traffic	traffic
train	train
training	training
transfer	transfer
transform	transform
translate	translate
translation	translation
transparent	transparent
transport	transport
transport	transport
trap	trap
travel	travel
traveller	traveller
treat	treat
treatment	treatment
tree	tree
trend	trend
trial	trial
triangle	triangle
trick	trick
trip	trip
tropical	tropical
trouble	trouble
trousers	trousers
truck	truck
true	true
truly	truly
trust	trust
truth	truth
try	try
tuan	tuan
tube	tube
tuesday	tuesday
tune	tune
tunnel	tunnel
turn	turn
tv	tv
twice	twice
twin	twin
twist	twist
twisted	twisted
type	type
typical	typical
typically	typically
tyre	tyre
ugly	ugly
ultimate	ultimate
ultimately	ultimately
umbrella	umbrella
unable	unable
unable	unable
unacceptable	unacceptable
unacceptable	unacceptable
uncertain	uncertain
uncertain	uncertain
uncle	uncle
uncomfortable	uncomfortable
uncomfortable	uncomfortable
unconscious	unconscious
unconscious	unconscious
uncontrolled	uncontrolled
uncontrolled	uncontrolled
under	under
under	under
underground	underground
underneath	underneath
understand	understand
understanding	understanding
underwater	underwater
underwear	underwear
undo	undo
undo	undo
unemployed	unemployed
unemployed	unemployed
unemployment	unemployment
unemployment	unemployment
unexpected	unexpected
unexpected,	unexpected,
unexpectedly	unexpectedly
unfair	unfair
unfair,	unfair,
unfairly	unfairly
unfortunate	unfortunate
unfortunately	unfortunately
unfriendly	unfriendly
unfriendly	unfriendly
unhappiness	unhappiness
unhappiness	unhappiness
unhappy	unhappy
unhappy	unhappy
uniform	uniform
unimportant	unimportant
unimportant	unimportant
union	union
unique	unique
unit	unit
unite	unite
united	united
universe	universe
university	university
unkind	unkind
unkind	unkind
unknown	unknown
unknown	unknown
unless	unless
unlike	unlike
unlike	unlike
unlikely	unlikely
unlikely	unlikely
unload	unload
unload	unload
unlucky	unlucky
unlucky	unlucky
unnecessary	unnecessary
unnecessary	unnecessary
unpleasant	unpleasant
unpleasant	unpleasant
unreasonable	unreasonable
unreasonable	unreasonable
unsteady	unsteady
unsteady	unsteady
unsuccessful	unsuccessful
unsuccessful	unsuccessful
untidy	untidy
untidy	untidy
until	until
unusual	unusual
unusual,	unusual,
unusually	unusually
unwilling	unwilling
unwilling,	unwilling,
unwillingly	unwillingly
up	up
upon	upon
upper	upper
upset	upset
upsetting	upsetting
upside	upside
upstairs	upstairs
upward	upward
upwards	upwards
urban	urban
urge	urge
urgent	urgent
us	us
use	use
used	used
used	used
used	used
useful	useful
useless	useless
user	user
usual	usual
usually	usually
vacation	vacation
valid	valid
valley	valley
valuable	valuable
value	value
van	van
variation	variation
varied	varied
variety	variety
various	various
vary	vary
vast	vast
vegetable	vegetable
vehicle	vehicle
venture	venture
version	version
vertical	vertical
very	very
via	via
victim	victim
victory	victory
video	video
view	view
village	village
violence	violence
violent	violent
violently	violently
virtually	virtually
virus	virus
visible	visible
vision	vision
visit	visit
visitor	visitor
vital	vital
vocabulary	vocabulary
voice	voice
volume	volume
vote	vote
wage	wage
waist	waist
wait	wait
waiter,	waiter,
wake	wake
walk	walk
walking	walking
wall	wall
wallet	wallet
wander	wander
want	want
war	war
warm	warm
warmth	warmth
warn	warn
warning	warning
wash	wash
washing	washing
waste	waste
watch	watch
water	water
wave	wave
way	way
we	we
weak	weak
weakness	weakness
wealth	wealth
weapon	weapon
wear	wear
weather	weather
web	web
website	website
wedding	wedding
wednesday	wednesday
week	week
weekend	weekend
weekly	weekly
weigh	weigh
weight	weight
welcome	welcome
well	well
well	well
well	well
west	west
western	western
wet	wet
what	what
whatever	whatever
wheel	wheel
when	when
whenever	whenever
where	where
whereas	whereas
wherever	wherever
whether	whether
which	which
while	while
whilst	whilst
whisper	whisper
whistle	whistle
white	white
who	who
whoever	whoever
whole	whole
whom	whom
whose	whose
why	why
wide	wide
widely	widely
width	width
wife	wife
wild	wild
wildly	wildly
will	will
willing	willing
willingly	willingly
willingness	willingness
win	win
wind	wind
wind	wind
wind	wind
window	window
wine	wine
wing	wing
winner	winner
winning	winning
winter	winter
wire	wire
wise	wise
wish	wish
with	with
withdraw	withdraw
within	within
without	without
witness	witness
woman	woman
wonder	wonder
wonderful	wonderful
wood	wood
wooden	wooden
wool	wool
word	word
work	work
worker	worker
working	working
world	world
worried	worried
worry	worry
worrying	worrying
worse,	worse,
worship	worship
worth	worth
wound	wound
wounded	wounded
wrap	wrap
wrapping	wrapping
wrist	wrist
write	write
writer	writer
writing	writing
written	written
wrong	wrong
wrongly	wrongly
yard	yard
yawn	yawn
yeah	yeah
year	year
yellow	yellow
yes	yes
yesterday	yesterday
yet	yet
you	you
young	young
your	your
yours	yours
yours-Truly-(NAmE)	yours-Truly-(NAmE)
yours-faithfully	yours-faithfully
yours-sincerely	yours-sincerely
yourself	yourself
youth	youth
zero-number	zero-number
zone	zone